# 要求
- 你需要翻译一些严肃的德文文本
- 译文严格保持原文的分句结构
- 在一些名词后有括号里的别称，这些名词和括号里的名词视为关键名词，关键名词需要经分析词源得到中文译文
- 中文译文需要使用现代白话（直白），避免书面性的表达，避免典籍中的表达，不要过于口语，不要使用文言词汇
- 最终得到的译文不要出现非中文文本
- 前述关键名词需要在译文中以名词（别称）的形式展现
- 除原文的标点符号以及对应的中文标点符号，不要添加多余的符号
- 复合名词需要根据语素原样的翻译为简洁的中文
- 除非原文有破折号，否则不要使用破折号修饰分句
# 固定的名词翻译
- urkräftigen (schöpferischen)  :  原初始动（创造性）
- wahrlichen Wahrheit: 真实真理
- Urquelle (Schöpfung) : 原初之源（创造）
- Entstehung (Schöpfung) : 起源（创造）
- Euresgleichen (Menschen): 人类（人）
- Unweisheit: 愚昧
- Anschwellung (Entwicklung/Evolution): 扩展（发展/进化）
- erzeugerischer (schöpferischer) :  原初始育（创造性）
- Lehre der Wahrheit: 真理教导
- die Lehre des Geistes: 精神教导
- die Lehre des Lebens : 生命教导
- Gestaltung (Schöpfung): 塑世始源（创造）
- Billigkeitslose : 不义的
- Verantwortungslose: 不负责任的
- Ungerechte: 不公正的
- Gerechtigkeitslose:  不正义的
- Erzeugung (Schöpfung) : 创世（创造）
- Erschaffenden 造物
- Erschaffung: 塑世始源
- Künder: 谕师
- Propheten: 先知
- Aussehen (Natur) : 形貌（自然）
- Erbauenden (Schöpfung) : 创世始构（创造）
- Urhebung: 原初动力
- Ursprungs：起源
- Gesicht (Augen): 面容（视线）
- Erbauung: 始筑
- Urkraft (Schöpfung): 原初力量（创造）
- Ursprünglichen：原初
- Weisheit: 智慧本源
- Einklang: 协调
- Harmonie: 和谐
- Formung: 造物
- Nokodemion: 诺科德米翁
- Daseins (Schöpfung) : 存在（创造）
- Fruchtbarkeit (Schöpfung): 育世（创造）
- Ungebühr (Beleidigung/Frevel) ：无礼（侮辱/亵渎）
# 原文文本
147) Ihr seid unter euch selbst ungerecht und also gegen euch selbst, also sollt ihr Billigkeit (Gerechtigkeit) gegen euch selbst und gegen Euresgleichen (Mitmenschen) lernen, auf dass ihr ein friedliches Miteinander und Frieden in euch selbst findet.